・	……	短縮よみ
どげざ	🙇	顔文字
おじぎ	🙇	顔文字
き	✨	短縮よみ
ねこ	🐈	記号
lgtm	修正ありがとうございます、問題なさそうです✨	短縮よみ
ｌｇｔｍ	修正ありがとうございます、問題なさそうです✨	短縮よみ
lgtm2	問題なさそうです！ありがとうございます✨	短縮よみ
あとあま	アトあま	固有名詞
かねふぉーむ	カネフォーム	固有名詞
すいみんそう	睡眠相	名詞
まめみるく	豆奶销售点	人名
おは	おはようございますー☀	短縮よみ
おは1	おはようございます✨	短縮よみ
おは2	おはようございますー✨	短縮よみ
おは3	おはようございます🌅	短縮よみ
おは4	おはようございます🌄	短縮よみ
おは5	おはようございます☀	短縮よみ
おは6	おはようございますー🍳	短縮よみ
おは7	おはようございます☼	短縮よみ
おは8	おはようございます🐾	短縮よみ
おは9	おはようございます🐈	短縮よみ
すい	(水)	短縮よみ
すいようび	(水)	短縮よみ
げつ	(月)	短縮よみ
げつようび	(月)	短縮よみ
か	(火)	短縮よみ
かようび	(火)	短縮よみ
もく	(木)	短縮よみ
もくようび	(木)	短縮よみ
きん	(金)	短縮よみ
きんようび	(金)	短縮よみ
ど	(土)	短縮よみ
どようび	(土)	短縮よみ
にち	(日)	短縮よみ
にちようび	(日)	短縮よみ
げつよう	(月)	短縮よみ
かよう	(火)	短縮よみ
すいよう	(水)	短縮よみ
もくよう	(木)	短縮よみ
きんよう	(金)	短縮よみ
どよう	(土)	短縮よみ
にちよう	(日)	短縮よみ